map :

*
04 04 04 04 04 03 04 04 04 04 04 04 04 88
04 00 00 07 00 03 00 00 00 00 00 00 04 88
04 00 00 03 00 00 00 04 00 05 03 03 03 88 
04 00 00 07 00 00 00 11 00 00 00 00 04 88
04 04 03 03 03 03 03 03 03 00 00 00 04 88
88 88 04 00 00 00 00 00 03 11 19 00 04 88
88 88 04 00 00 03 00 00 00 00 00 00 04 88
04 04 04 00 00 00 19 00 23 00 03 00 04 88
04 00 00 00 03 00 00 00 00 16 03 00 04 88
04 00 00 00 09 03 03 03 00 00 00 00 04 88
04 00 00 00 00 00 00 03 00 00 00 00 04 88
04 04 04 04 04 04 04 03 04 04 04 04 04 88
88 88 88 88 88 88 88 88 88 88 88 88 88 88


taille de molecule en y et x :

*
3 5


molécule victoire :

*
88 11 88 11 88
09 19 23 19 05
88 07 16 07 88
*