map :

*
88 88 88 88 88 88 88 88 88 03 03 03 03 88
03 03 03 03 03 03 88 03 03 03 00 00 03 88
03 00 00 00 00 03 88 03 00 00 00 00 03 88
03 00 00 00 00 03 03 03 00 00 04 00 03 88
03 00 04 04 00 00 00 00 00 00 00 00 03 88
03 00 00 00 00 00 00 00 00 04 04 04 04 88
04 04 04 04 24 09 04 04 00 00 00 00 03 88
03 00 00 00 00 00 18 00 00 00 04 00 03 88
04 04 00 00 04 00 04 00 00 04 13 04 04 88
03 00 00 00 04 00 00 00 00 00 00 00 03 88
04 04 00 00 00 00 05 00 04 00 04 00 03 88
03 00 00 00 00 00 04 00 04 00 00 00 03 88
03 03 03 03 03 03 04 03 04 03 03 03 03 88


taille de molecule en y et x :

*
2 4


molécule victoire :

*
88 18 88 88
09 24 13 05
*