
*
04 04 04 04 04 88 88 04 04 04 04 04 04 04 
04 00 00 07 04 88 88 04 19 00 00 11 00 04 
04 00 03 03 03 88 88 04 00 11 00 00 00 04 
04 00 00 00 04 88 88 04 00 03 03 03 10 04 
04 07 00 19 04 88 88 04 25 00 00 03 00 04 
04 00 03 00 04 88 88 04 00 03 19 03 07 04 
03 03 03 00 04 04 04 04 00 03 00 00 00 04 
04 00 00 00 00 00 00 00 07 00 00 03 03 03 
04 00 00 00 11 00 03 03 03 03 19 00 00 04 
04 00 11 00 00 00 11 00 00 07 00 00 00 04 
04 00 00 00 12 00 09 05 04 04 04 04 19 04 
04 00 00 00 00 00 00 00 04 88 88 04 00 04 
04 04 04 04 04 04 04 04 04 88 88 04 04 04 


taille de molecule en y et x :

*
4 7


molécule victoire :


*
88 88 10 11 12 88 88
88 11 11 25 11 11 88
09 19 19 19 19 19 05
88 07 07 07 07 07 88
*