



Tableau de map, 88 représente du vide, les autres nombres
représentent l'élément identifiable sur la spritesheet

c'est pas super lisible mais jai pas trouvé comment faire mieux :s


*
88 88 88 88 88 88 88 88 88 88 88 88 88 88
88 88 88 88 88 88 88 88 88 88 88 88 88 88
03 03 03 03 03 88 88 88 88 88 88 88 88 88
03 00 00 00 03 88 88 88 88 88 88 88 88 88
03 00 00 05 03 03 03 03 03 03 88 88 88 88
03 00 00 03 00 00 00 00 00 03 88 88 88 88
03 00 03 00 00 00 00 00 00 03 03 88 88 88
03 00 03 00 00 03 00 03 03 00 03 88 88 88
03 00 00 00 00 03 00 03 13 00 03 88 88 88
03 03 03 09 03 00 00 03 00 00 03 88 88 88
88 03 00 00 00 00 00 00 00 00 03 88 88 88
88 03 03 03 03 03 03 03 03 03 03 88 88 88
88 88 88 88 88 88 88 88 88 88 88 88 88 88


taille de molecule en y et x :

*
1 3


molécule victoire :


*
09 13 05
*