map :

*
04 04 04 04 88 88 88 88 88 88 88 88 88 88
04 00 00 04 88 88 88 88 88 88 88 88 88 88
04 00 00 04 88 88 88 88 88 88 88 88 88 88 
04 00 11 04 88 88 88 88 88 88 88 88 88 88
04 00 00 04 04 04 04 04 04 04 04 88 88 88
04 00 00 00 04 00 00 00 04 00 04 04 04 88
04 00 04 00 00 00 00 00 04 00 00 00 04 88
04 00 00 00 00 00 00 00 04 19 00 00 04 88
04 00 09 04 04 04 13 00 04 00 04 00 04 88
04 00 00 00 00 00 00 00 00 00 00 00 04 88
04 00 00 00 00 07 00 04 05 00 04 00 04 88
04 04 04 04 04 04 00 00 00 00 04 00 04 88
88 88 88 88 88 04 04 04 04 04 04 04 04 88


taille de molecule en y et x :

*
3 4


molécule victoire :

*
88 11 88 88
09 19 13 05
88 07 88 88
*