map :

*
03 03 04 03 03 03 03 88 88 88 88 88 88 88
03 00 04 00 00 00 03 88 88 88 88 88 88 88
03 00 04 08 03 00 03 88 88 88 88 88 88 88 
03 00 04 00 00 00 03 88 88 88 88 88 88 88
03 00 04 00 00 00 03 88 88 88 88 88 88 88
03 00 00 00 04 04 04 03 03 03 03 88 88 88
03 00 00 00 00 00 00 00 00 00 03 88 88 88
03 00 20 04 04 21 00 12 00 00 03 88 88 88
03 00 00 00 00 00 00 04 04 04 04 88 88 88
04 04 00 00 04 10 00 00 00 00 03 88 88 88
03 00 00 00 04 00 03 00 00 00 03 88 88 88
03 00 00 06 04 00 00 00 03 03 03 88 88 88
03 03 03 03 04 03 03 03 03 88 88 88 88 88


taille de molecule en y et x :

*
3 4


molécule victoire :

*
10 88 88 12
88 21 20 88
08 88 88 06
*