map :

*
04 04 04 04 04 04 04 04 04 04 04 88 88 88
04 00 00 00 00 00 04 00 11 00 04 88 88 88
04 00 00 00 00 00 04 00 00 00 04 88 88 88 
04 00 00 04 00 00 14 00 00 00 04 88 88 88
04 00 11 04 07 04 04 04 04 00 04 04 88 88
04 00 00 04 00 04 00 07 04 19 00 04 88 88
04 00 04 04 00 00 00 00 04 00 00 04 88 88
04 00 00 00 00 00 00 00 04 11 00 04 88 88
04 00 19 04 00 00 00 04 04 00 00 04 88 88
04 00 00 03 04 00 00 07 00 05 00 04 88 88
04 00 00 09 04 00 00 19 00 04 04 04 88 88
04 00 00 00 04 00 00 04 00 00 00 04 88 88
04 04 04 04 04 04 04 04 04 04 04 04 88 88


taille de molecule en y et x :

*
4 5


molécule victoire :

*
88 11 11 11 88
09 19 19 19 05
88 07 14 07 88
88 88 07 88 88
*