*
88 88 88 88 88 88 88 88 88 88 88 88 88 88 
88 88 88 88 88 88 88 88 88 88 88 88 88 88 
88 88 88 88 88 88 88 88 88 88 88 88 88 88 
88 88 88 88 88 88 88 88 88 88 88 88 88 88 
88 88 88 88 88 88 10 11 12 88 88 88 88 88 
88 88 88 88 88 11 11 25 11 11 88 88 88 88 
88 88 88 88 09 19 19 19 19 19 88 05 88 88 
88 88 88 88 88 07 07 07 07 07 88 88 88 88  
88 88 88 88 88 88 88 88 88 88 88 88 88 88 
88 88 88 88 88 88 88 88 88 88 88 88 88 88 
88 88 88 88 88 88 88 88 88 88 88 88 88 88 
88 88 88 88 88 88 88 88 88 88 88 88 88 88 


taille de molecule en y et x :

*
4 7


molécule victoire :


*
88 88 10 11 12 88 88
88 11 11 25 11 11 88
09 19 19 19 19 19 05
88 07 07 07 07 07 88
*