map :

*
88 88 88 88 88 88 03 03 03 03 88 88 88 88
88 88 03 03 03 03 03 00 00 03 88 88 88 88
88 88 03 00 00 00 00 00 12 03 88 88 88 88 
88 88 03 00 00 11 03 03 03 03 03 03 03 03 
88 88 03 22 00 00 00 00 00 03 00 00 00 03 
88 88 04 04 04 04 00 00 03 03 00 20 00 03 
03 03 03 09 00 04 00 00 19 03 00 00 00 03 
03 00 00 00 00 04 00 00 00 00 11 00 00 03 
03 00 04 00 00 04 00 04 04 04 04 04 04 04
03 00 00 00 00 00 00 00 00 00 00 00 00 03 
03 00 00 00 04 00 00 00 00 04 04 00 00 03 
03 06 00 00 04 00 00 00 00 07 00 00 00 03 
03 03 03 03 04 03 03 03 03 03 03 03 03 03 


taille de molecule en y et x :

*
3 5


molécule victoire :

*
88 11 11 88 12
09 19 22 20 88
88 07 88 88 06
*