

map :

*
04 04 04 04 04 88 88 88 88 88 88 88 88 88
04 00 00 00 04 88 88 88 88 88 88 88 88 88
04 00 00 00 03 04 03 04 04 04 04 04 04 04 
04 00 03 00 03 00 03 00 00 00 00 00 00 04 
04 00 03 00 03 19 03 00 00 11 03 00 00 04 
04 00 09 03 00 00 03 03 03 03 03 00 00 04 
04 00 00 00 00 00 00 00 03 00 00 00 00 04 
04 00 00 00 00 00 00 00 03 00 00 00 00 04 
04 00 03 03 03 03 03 00 05 00 00 00 00 04 
04 00 00 07 03 00 00 04 04 04 04 04 04 04 
04 04 04 04 03 04 04 04 88 88 88 88 88 88
88 88 88 88 88 88 88 88 88 88 88 88 88 88
88 88 88 88 88 88 88 88 88 88 88 88 88 88


taille de molecule en y et x :

*
3 3


molécule victoire :

*
88 11 88
09 19 05
88 07 88
*