map :

*
04 04 04 04 04 04 04 04 04 04 04 88 88 88
04 00 00 11 00 00 00 00 00 00 04 88 88 88
04 00 03 03 00 00 03 00 00 00 04 88 88 88 
04 00 00 00 00 00 19 03 00 00 04 88 88 88
04 00 00 00 03 00 00 03 00 00 04 88 88 88
04 00 03 05 03 00 00 03 19 00 04 88 88 88
04 00 00 00 00 00 00 00 00 03 04 04 04 88
04 04 03 03 03 00 00 03 00 00 00 00 04 88
88 04 00 00 00 13 00 03 00 03 00 00 04 88
04 04 09 03 03 00 00 00 00 11 00 00 04 88
04 00 00 00 00 00 07 00 04 04 04 04 04 88 
04 00 00 00 07 00 03 00 04 88 88 88 88 88
04 04 04 04 04 04 04 04 04 88 88 88 88 88


taille de molecule en y et x :

*
3 5


molécule victoire :

*
88 11 11 88 88
09 19 19 13 05
88 07 07 88 88
*