map :

*
88 88 88 88 88 88 88 88 88 88 88 88 88 88
88 88 88 88 88 88 88 88 88 88 88 88 88 88
03 03 03 03 03 03 03 03 03 03 88 88 88 88 
03 00 00 00 00 00 00 15 00 03 88 88 88 88
03 00 00 03 03 03 00 03 00 03 88 88 88 88
03 00 00 00 00 00 11 03 00 03 88 88 88 88
03 00 03 03 00 00 19 00 00 03 88 88 88 88
03 00 09 00 00 07 00 03 11 03 88 88 88 88
03 00 03 03 03 03 00 03 00 03 88 88 88 88
03 00 00 00 22 00 00 00 00 03 88 88 88 88
03 00 03 00 00 03 03 03 03 03 88 88 88 88
03 00 03 00 00 03 88 88 88 88 88 88 88 88
03 03 03 03 03 03 88 88 88 88 88 88 88 88


taille de molecule en y et x :

*
3 4


molécule victoire :

*
88 11 11 88
09 19 22 15
88 07 88 88
*